Quel est l'enseignant du cours de Statistique inférentielle ?	L'enseignant de Statistique inférentielle est Pr. profSI
Qui enseigne l'UE de Statistique inférentielle ?	L'enseignant de Statistique inférentielle est Pr. profSI
Qui est le prof de Statistique inférentielle ?	L'enseignant de Statistique inférentielle est Pr. profSI
Qui donne le cours de Statistique inférentielle ?	L'enseignant de Statistique inférentielle est Pr. profSI
Quel est l'enseignant de l'UE de Statistique ?	L'enseignant de Statistique inférentielle est Pr. profSI
Qui enseigne le cours de Statistique ?	L'enseignant de Statistique inférentielle est Pr. profSI
Qui fait l'UE de Statistique inférentielle ?	L'enseignant de Statistique inférentielle est Pr. profSI
Qui fait le cours de Statistique ?	L'enseignant de Statistique inférentielle est Pr. profSI
Quel est le professeur de Statistique ?	L'enseignant de Statistique inférentielle est Pr. profSI
Qui est le responsable du cours de Statistique inférentielle ?	L'enseignant de Statistique inférentielle est Pr. profSI

Fait-on des Statistiques ?	Oui, une UE de Statistique inférentielle est au programme
Il y a des Statistiques ?	Oui, une UE de Statistique inférentielle est au programme
Y a-t-il des cours de Statistique ?	Oui, une UE de Statistique inférentielle est au programme
Est ce que le master propose un enseignement en Statistique inférentielle ?	Oui, une UE de Statistique inférentielle est au programme
Est-ce qu'on fait de la Statistique inférentielle ?	Oui, une UE de Statistique inférentielle est au programme
Il y a des cours de Statistique ?	Oui, une UE de Statistique inférentielle est au programme
Il y a de la Statistique inférentielle ?	Oui, une UE de Statistique inférentielle est au programme
Fait on des Statistiques inférentielles ?	Oui, une UE de Statistique inférentielle est au programme
Il y a des cours de Statistique inférentielle ?	Oui, une UE de Statistique inférentielle est au programme
Il y a des cours de Statistique ?	Oui, une UE de Statistique inférentielle est au programme
Y a-t-il des Statistiques inférentielles ?	Oui, une UE de Statistique inférentielle est au programme
Y a-t-il un cours de Statistique inférentielle ?	Oui, une UE de Statistique inférentielle est au programme
On fait des Statistiques inférentielles ?	Oui, une UE de Statistique inférentielle est au programme
On fait de la Statistique ?	Oui, une UE de Statistique inférentielle est au programme
Il y a des Statistiques inférentielles dans ce master ?	Oui, une UE de Statistique inférentielle est au programme
Est ce qu'il y a des cours de Statistique inférentielle ?	Oui, une UE de Statistique inférentielle est au programme

C'est quoi les Statistiques inférentielles ?	Je vous invite à faire une recherche Wikipedia ou à consulter le site de l'enseignant
Qu'est ce que les Statistiques inférentielles ?	Je vous invite à faire une recherche Wikipedia ou à consulter le site de l'enseignant
C'est quoi les Statistiques ?	Je vous invite à faire une recherche Wikipedia ou à consulter le site de l'enseignant

Que faut il lire en Statistique inférentielle ?	Vous devriez prendre contact avec l'enseignant de l'UE et lui demander
Il y a des livres à lire en Statistique ?	Vous devriez prendre contact avec l'enseignant de l'UE et lui demander
Le cours de Statistique inférentielle est-il en ligne ?	Vous devriez prendre contact avec l'enseignant de l'UE et lui demander
Il faut des connaissances préalables en Statistique ?	Vous devriez prendre contact avec l'enseignant de l'UE et lui demander

Il y a des TP de Statistique inférentielle ?	Il y a plusieurs TP sur SAS et R : introduction à SAS, programmation avancée avec SAS, les tests statistiques.
Quels sont les TP de Statistique inférentielle ?	Il y a plusieurs TP sur SAS et R : introduction à SAS, programmation avancée avec SAS, les tests statistiques.
Il y a des TP de Statistique ?	Il y a plusieurs TP sur SAS et R : introduction à SAS, programmation avancée avec SAS, les tests statistiques.
Il y a des Travaux Pratiques de Statistique ?	Il y a plusieurs TP sur SAS et R : introduction à SAS, programmation avancée avec SAS, les tests statistiques.
Quels sont les Travaux Pratiques de Statistique inférentielle ?	Il y a plusieurs TP sur SAS et R : introduction à SAS, programmation avancée avec SAS, les tests statistiques.
Il y a des exercices pratiques de Statistique ?	Il y a plusieurs TP sur SAS et R : introduction à SAS, programmation avancée avec SAS, les tests statistiques.
Quels sont les exercices pratiques de Statistique inférentielle ?	Il y a plusieurs TP sur SAS et R : introduction à SAS, programmation avancée avec SAS, les tests statistiques.

Quel est le programme de statistiques ?	Dans l'UE Statistique inférentielle, vous verrez les méthodes d'estimation ponctuelle : du maximum de vraisemblance, des moments, des moindres carrés. Étude de propriétés. Estimation par intervalle. Tests d'hypothèse paramétriques. Lemme de Neyman-Pearson. Test du maximum de vraisemblance, test de Wald.
C'est quoi le programme de Statistique inférentielle ?	Dans l'UE Statistique inférentielle, vous verrez les méthodes d'estimation ponctuelle : du maximum de vraisemblance, des moments, des moindres carrés. Étude de propriétés. Estimation par intervalle. Tests d'hypothèse paramétriques. Lemme de Neyman-Pearson. Test du maximum de vraisemblance, test de Wald.
On fait quoi en Statistique inférentielle ?	Dans l'UE Statistique inférentielle, vous verrez les méthodes d'estimation ponctuelle : du maximum de vraisemblance, des moments, des moindres carrés. Étude de propriétés. Estimation par intervalle. Tests d'hypothèse paramétriques. Lemme de Neyman-Pearson. Test du maximum de vraisemblance, test de Wald.
Quel est le contenu de l'UE Statistique inférentielle ?	Dans l'UE Statistique inférentielle, vous verrez les méthodes d'estimation ponctuelle : du maximum de vraisemblance, des moments, des moindres carrés. Étude de propriétés. Estimation par intervalle. Tests d'hypothèse paramétriques. Lemme de Neyman-Pearson. Test du maximum de vraisemblance, test de Wald.
Quel est le contenu du cours de Statistique inférentielle ?	Dans l'UE Statistique inférentielle, vous verrez les méthodes d'estimation ponctuelle : du maximum de vraisemblance, des moments, des moindres carrés. Étude de propriétés. Estimation par intervalle. Tests d'hypothèse paramétriques. Lemme de Neyman-Pearson. Test du maximum de vraisemblance, test de Wald.
Quels sont les thèmes abordés en Statistique inférentielle ?	Dans l'UE Statistique inférentielle, vous verrez les méthodes d'estimation ponctuelle : du maximum de vraisemblance, des moments, des moindres carrés. Étude de propriétés. Estimation par intervalle. Tests d'hypothèse paramétriques. Lemme de Neyman-Pearson. Test du maximum de vraisemblance, test de Wald.
Vous faites quoi en Statistique inférentielle?	Dans l'UE Statistique inférentielle, vous verrez les méthodes d'estimation ponctuelle : du maximum de vraisemblance, des moments, des moindres carrés. Étude de propriétés. Estimation par intervalle. Tests d'hypothèse paramétriques. Lemme de Neyman-Pearson. Test du maximum de vraisemblance, test de Wald.
Quels sont les méthodes enseignées en Statistique inférentielle ?	Dans l'UE Statistique inférentielle, vous verrez les méthodes d'estimation ponctuelle : du maximum de vraisemblance, des moments, des moindres carrés. Étude de propriétés. Estimation par intervalle. Tests d'hypothèse paramétriques. Lemme de Neyman-Pearson. Test du maximum de vraisemblance, test de Wald.
Quels sont les algorithmes de Statistique inférentielle enseignés ?	Dans l'UE Statistique inférentielle, vous verrez les méthodes d'estimation ponctuelle : du maximum de vraisemblance, des moments, des moindres carrés. Étude de propriétés. Estimation par intervalle. Tests d'hypothèse paramétriques. Lemme de Neyman-Pearson. Test du maximum de vraisemblance, test de Wald.
Vous enseignez quoi en Statistique inférentielle ?	Dans l'UE Statistique inférentielle, vous verrez les méthodes d'estimation ponctuelle : du maximum de vraisemblance, des moments, des moindres carrés. Étude de propriétés. Estimation par intervalle. Tests d'hypothèse paramétriques. Lemme de Neyman-Pearson. Test du maximum de vraisemblance, test de Wald.