Quel est l'enseignant du cours de Machine Learning ?	L'enseignant de Machine Learning est Pr. profML
Quel est l'enseignant de l'UE de Machine Learning ?	L'enseignant de Machine Learning est Pr. profML
Qui enseigne l'UE machine learning ?	L'enseignant de Machine Learning est Pr. profML
Qui enseigne le cours de machine learning ?	L'enseignant de Machine Learning est Pr. profML
Qui fait l'UE de machine learning ?	L'enseignant de Machine Learning est Pr. profML
Qui fait le cours de machine learning ?	L'enseignant de Machine Learning est Pr. profML
Qui est le prof de Machine Learning ?	L'enseignant de Machine Learning est Pr. profML
Qui donne le cours de machine learning ?	L'enseignant de Machine Learning est Pr. profML
Quel est le professeur de Machine Learning ?	L'enseignant de Machine Learning est Pr. profML
Qui est le responsable du cours de Machine Learning ?	L'enseignant de Machine Learning est Pr. profML

Est ce que le master propose un enseignement en Machine Learning ?	Oui, il a deux cours d'apprentissage statistique au programme : Machine Learning (ML) et Probabilistic Graphical Models (PGM)
Il y a du Machine Learning ?	Oui, il a deux cours d'apprentissage statistique au programme : Machine Learning (ML) et Probabilistic Graphical Models (PGM)
Fait on du Machine Learning ?	Oui, il a deux cours d'apprentissage statistique au programme : Machine Learning (ML) et Probabilistic Graphical Models (PGM)
Il y a des cours de Machine Learning ?	Oui, il a deux cours d'apprentissage statistique au programme : Machine Learning (ML) et Probabilistic Graphical Models (PGM)
Y a-t-il un cours de Machine Learning ?	Oui, il a deux cours d'apprentissage statistique au programme : Machine Learning (ML) et Probabilistic Graphical Models (PGM)
On fait du Machine Learning ?	Oui, il a deux cours d'apprentissage statistique au programme : Machine Learning (ML) et Probabilistic Graphical Models (PGM)
Il y a du Machine Learning dans ce master ?	Oui, il a deux cours d'apprentissage statistique au programme : Machine Learning (ML) et Probabilistic Graphical Models (PGM)
Est ce qu'il y a des cours de Machine Learning ?	Oui, il a deux cours d'apprentissage statistique au programme : Machine Learning (ML) et Probabilistic Graphical Models (PGM)

Il y a des cours en apprentissage statistique ?	Oui, il a deux cours d'apprentissage statistique au programme : Machine Learning (ML) et Probabilistic Graphical Models (PGM)
Y a-t-il un cours en apprentissage statistique ?	Oui, il a deux cours d'apprentissage statistique au programme : Machine Learning (ML) et Probabilistic Graphical Models (PGM)
On fait de l'apprentissage statistique ?	Oui, il a deux cours d'apprentissage statistique au programme : Machine Learning (ML) et Probabilistic Graphical Models (PGM)
Il y a de l'apprentissage statistique dans ce master ?	Oui, il a deux cours d'apprentissage statistique au programme : Machine Learning (ML) et Probabilistic Graphical Models (PGM)
Est ce qu'il y a des cours en apprentissage statistique ?	Oui, il a deux cours d'apprentissage statistique au programme : Machine Learning (ML) et Probabilistic Graphical Models (PGM)

Il y a des cours en apprentissage numérique ?	Oui, il a deux cours d'apprentissage statistique au programme : Machine Learning (ML) et Probabilistic Graphical Models (PGM)
Y a-t-il un cours en apprentissage numérique ?	Oui, il a deux cours d'apprentissage statistique au programme : Machine Learning (ML) et Probabilistic Graphical Models (PGM)
On fait de l'apprentissage numérique ?	Oui, il a deux cours d'apprentissage statistique au programme : Machine Learning (ML) et Probabilistic Graphical Models (PGM)
Il y a de l'apprentissage numérique dans ce master ?	Oui, il a deux cours d'apprentissage statistique au programme : Machine Learning (ML) et Probabilistic Graphical Models (PGM)
Est ce qu'il y a des cours en apprentissage numérique ?	Oui, il a deux cours d'apprentissage statistique au programme : Machine Learning (ML) et Probabilistic Graphical Models (PGM)

Il y a des cours en apprentissage artificiel ?	Oui, il a deux cours d'apprentissage statistique au programme : Machine Learning (ML) et Probabilistic Graphical Models (PGM)
Y a-t-il un cours en apprentissage artificiel ?	Oui, il a deux cours d'apprentissage statistique au programme : Machine Learning (ML) et Probabilistic Graphical Models (PGM)
On fait de l'apprentissage artificiel ?	Oui, il a deux cours d'apprentissage statistique au programme : Machine Learning (ML) et Probabilistic Graphical Models (PGM)
Il y a de l'apprentissage artificiel dans ce master ?	Oui, il a deux cours d'apprentissage statistique au programme : Machine Learning (ML) et Probabilistic Graphical Models (PGM)
Est ce qu'il y a des cours en apprentissage artificiel ?	Oui, il a deux cours d'apprentissage statistique au programme : Machine Learning (ML) et Probabilistic Graphical Models (PGM)

Il y a des cours en intelligence artificielle ?	Oui, il a deux cours d'apprentissage statistique au programme : Machine Learning (ML) et Probabilistic Graphical Models (PGM)
Y a-t-il un cours en intelligence artificielle ?	Oui, il a deux cours d'apprentissage statistique au programme : Machine Learning (ML) et Probabilistic Graphical Models (PGM)
On fait de l'intelligence artificielle ?	Oui, il a deux cours d'apprentissage statistique au programme : Machine Learning (ML) et Probabilistic Graphical Models (PGM)
Il y a de l'intelligence artificielle dans ce master ?	Oui, il a deux cours d'apprentissage statistique au programme : Machine Learning (ML) et Probabilistic Graphical Models (PGM)
Est ce qu'il y a des cours en intelligence artificielle ?	Oui, il a deux cours d'apprentissage statistique au programme : Machine Learning (ML) et Probabilistic Graphical Models (PGM)

Qu'est ce que le apprentissage statistique ?	Je vous invite à faire une recherche Wikipedia ou à consulter le site de l'enseignant
C'est quoi le apprentissage statistique ?	Je vous invite à faire une recherche Wikipedia ou à consulter le site de l'enseignant
Qu'est ce que le apprentissage numérique ?	Je vous invite à faire une recherche Wikipedia ou à consulter le site de l'enseignant
C'est quoi le apprentissage numérique ?	Je vous invite à faire une recherche Wikipedia ou à consulter le site de l'enseignant
Qu'est ce que le machine learning ?	Je vous invite à faire une recherche Wikipedia ou à consulter le site de l'enseignant
C'est quoi le machine learning ?	Je vous invite à faire une recherche Wikipedia ou à consulter le site de l'enseignant

Que faut il lire en machine learning ?	Vous devriez prendre contact avec l'enseignant de l'UE et lui demander
Il y a des livres à lire en machine learning ?	Vous devriez prendre contact avec l'enseignant de l'UE et lui demander
Le cours de machine learning est-il en ligne ?	Vous devriez prendre contact avec l'enseignant de l'UE et lui demander
Il faut des connaissances préalables en machine learning ?	Vous devriez prendre contact avec l'enseignant de l'UE et lui demander

Il y a des TP de machine learning ?	Trois travaux pratiques sont proposés dans l'UE Machine Learning. TP1 : Clustering, réduction de dimension, TP2 : Classification binaire, Feature engineering, sélection de variables, TP3 : Détection d'anomalies. 
Quels sont les TP de machine learning ?	Trois travaux pratiques sont proposés dans l'UE Machine Learning. TP1 : Clustering, réduction de dimension, TP2 : Classification binaire, Feature engineering, sélection de variables, TP3 : Détection d'anomalies. 
Il y a des Travaux Pratiques de machine learning ?	Trois travaux pratiques sont proposés dans l'UE Machine Learning. TP1 : Clustering, réduction de dimension, TP2 : Classification binaire, Feature engineering, sélection de variables, TP3 : Détection d'anomalies. 
Quels sont les Travaux Pratiques de machine learning ?	Trois travaux pratiques sont proposés dans l'UE Machine Learning. TP1 : Clustering, réduction de dimension, TP2 : Classification binaire, Feature engineering, sélection de variables, TP3 : Détection d'anomalies. 
Il y a des exercices pratiques de machine learning ?	Trois travaux pratiques sont proposés dans l'UE Machine Learning. TP1 : Clustering, réduction de dimension, TP2 : Classification binaire, Feature engineering, sélection de variables, TP3 : Détection d'anomalies. 
Quels sont les exercices pratiques de machine learning ?	Trois travaux pratiques sont proposés dans l'UE Machine Learning. TP1 : Clustering, réduction de dimension, TP2 : Classification binaire, Feature engineering, sélection de variables, TP3 : Détection d'anomalies. 

C'est quoi le programme de machine learning ?	Dans l'UE Machine Learning vous verrez des algorithmes d'apprentissage supervisé : classification naïve bayésienne, arbres de décision, méthodes ensemblistes (Random Forest, Boosting etc.), Support Vector Machines (SVM) et les réseaux de neurones (convolution networks, recurrent networks) etc.
On fait quoi en machine learning ?	Dans l'UE Machine Learning vous verrez des algorithmes d'apprentissage supervisé : classification naïve bayésienne, arbres de décision, méthodes ensemblistes (Random Forest, Boosting etc.), Support Vector Machines (SVM) et les réseaux de neurones (convolution networks, recurrent networks) etc.
Quel est le contenu du cours de machine learning ?	Dans l'UE Machine Learning vous verrez des algorithmes d'apprentissage supervisé : classification naïve bayésienne, arbres de décision, méthodes ensemblistes (Random Forest, Boosting etc.), Support Vector Machines (SVM) et les réseaux de neurones (convolution networks, recurrent networks) etc.
Quels sont les thèmes abordés en machine learning ?	Dans l'UE Machine Learning vous verrez des algorithmes d'apprentissage supervisé : classification naïve bayésienne, arbres de décision, méthodes ensemblistes (Random Forest, Boosting etc.), Support Vector Machines (SVM) et les réseaux de neurones (convolution networks, recurrent networks) etc.
Vous faites quoi en machine learning ?	Dans l'UE Machine Learning vous verrez des algorithmes d'apprentissage supervisé : classification naïve bayésienne, arbres de décision, méthodes ensemblistes (Random Forest, Boosting etc.), Support Vector Machines (SVM) et les réseaux de neurones (convolution networks, recurrent networks) etc.
Quels sont les méthodes enseignées en machine learning ?	Dans l'UE Machine Learning vous verrez des algorithmes d'apprentissage supervisé : classification naïve bayésienne, arbres de décision, méthodes ensemblistes (Random Forest, Boosting etc.), Support Vector Machines (SVM) et les réseaux de neurones (convolution networks, recurrent networks) etc.
Quels sont les algorithmes de machine learning enseignés ?	Dans l'UE Machine Learning vous verrez des algorithmes d'apprentissage supervisé : classification naïve bayésienne, arbres de décision, méthodes ensemblistes (Random Forest, Boosting etc.), Support Vector Machines (SVM) et les réseaux de neurones (convolution networks, recurrent networks) etc.
Vous enseignez quoi en machine learning ?	Dans l'UE Machine Learning vous verrez des algorithmes d'apprentissage supervisé : classification naïve bayésienne, arbres de décision, méthodes ensemblistes (Random Forest, Boosting etc.), Support Vector Machines (SVM) et les réseaux de neurones (convolution networks, recurrent networks) etc.