Quel est l'enseignant du cours de Cloud Computing ?	L'enseignant de Cloud computing est Pr. profCC
Qui enseigne l'UE Cloud Computing ?	L'enseignant de Cloud computing est Pr. profCC
Qui est le prof de Cloud Computing ?	L'enseignant de Cloud computing est Pr. profCC
Qui donne le cours de Cloud Computing ?	L'enseignant de Cloud computing est Pr. profCC
Quel est l'enseignant de l'UE de Cloud ?	L'enseignant de Cloud computing est Pr. profCC
Qui enseigne le cours de Cloud ?	L'enseignant de Cloud computing est Pr. profCC
Qui fait l'UE de Cloud Computing ?	L'enseignant de Cloud computing est Pr. profCC
Qui fait le cours de Cloud ?	L'enseignant de Cloud computing est Pr. profCC
Quel est le professeur de Cloud ?	L'enseignant de Cloud computing est Pr. profCC
Qui est le responsable du cours de Cloud Computing ?	L'enseignant de Cloud computing est Pr. profCC

Est ce que le master propose un enseignement en Cloud Computing ?	Oui, une UE de Cloud Computing est au programme
Il y a du Cloud Computing ?	Oui, une UE de Cloud Computing est au programme
Fait on du Cloud Computing ?	Oui, une UE de Cloud Computing est au programme
Il y a des cours de Cloud ?	Oui, une UE de Cloud Computing est au programme
Y a-t-il un cours de Cloud Computing ?	Oui, une UE de Cloud Computing est au programme
On fait du Cloud Computing ?	Oui, une UE de Cloud Computing est au programme
Il y a du Cloud Computing dans ce master ?	Oui, une UE de Cloud Computing est au programme
Est ce qu'il y a des cours de Cloud Computing ?	Oui, une UE de Cloud Computing est au programme

Qu'est ce que le Cloud Computing ?	Je vous invite à faire une recherche Wikipedia ou à consulter le site de l'enseignant
C'est quoi le Cloud ?	Je vous invite à faire une recherche Wikipedia ou à consulter le site de l'enseignant

Que faut il lire en Cloud Computing ?	Vous devriez prendre contact avec l'enseignant de l'UE et lui demander
Il y a des livres à lire en Cloud ?	Vous devriez prendre contact avec l'enseignant de l'UE et lui demander
Le cours de Cloud Computing est-il en ligne ?	Vous devriez prendre contact avec l'enseignant de l'UE et lui demander
Il faut des connaissances préalables en Cloud ?	Vous devriez prendre contact avec l'enseignant de l'UE et lui demander

Il y a des TP de Cloud ?	Quatre travaux pratiques sont proposés dans l'UE Cloud Computing. TP1 : Introduction à Docker, TP2 : Utilisation de Docker, TP3 : Utilisation de Swarm, TP4 : Introduction à Kubernetes.
Quels sont les TP de Cloud Computing ?	Quatre travaux pratiques sont proposés dans l'UE Cloud Computing. TP1 : Introduction à Docker, TP2 : Utilisation de Docker, TP3 : Utilisation de Swarm, TP4 : Introduction à Kubernetes.
Il y a des Travaux Pratiques de Cloud ?	Quatre travaux pratiques sont proposés dans l'UE Cloud Computing. TP1 : Introduction à Docker, TP2 : Utilisation de Docker, TP3 : Utilisation de Swarm, TP4 : Introduction à Kubernetes.
Quels sont les Travaux Pratiques de Cloud Computing ?	Quatre travaux pratiques sont proposés dans l'UE Cloud Computing. TP1 : Introduction à Docker, TP2 : Utilisation de Docker, TP3 : Utilisation de Swarm, TP4 : Introduction à Kubernetes.
Il y a des exercices pratiques de Cloud ?	Quatre travaux pratiques sont proposés dans l'UE Cloud Computing. TP1 : Introduction à Docker, TP2 : Utilisation de Docker, TP3 : Utilisation de Swarm, TP4 : Introduction à Kubernetes.
Quels sont les exercices pratiques de Cloud Computing ?	Quatre travaux pratiques sont proposés dans l'UE Cloud Computing. TP1 : Introduction à Docker, TP2 : Utilisation de Docker, TP3 : Utilisation de Swarm, TP4 : Introduction à Kubernetes.

C'est quoi le programme de Cloud Computing ?	Dans l'UE Cloud Computing, vous aurez une introduction au Cloud sur les modèles : IaaS (Modèle de service, Énergie, Composition), PaaS, SaaS. Ainsi qu'une introduction à Docker, à Swarm et à la virtualisation.
On fait quoi en Cloud Computing ?	Dans l'UE Cloud Computing, vous aurez une introduction au Cloud sur les modèles : IaaS (Modèle de service, Énergie, Composition), PaaS, SaaS. Ainsi qu'une introduction à Docker, à Swarm et à la virtualisation.
Quel est le contenu du cours de Cloud Computing ?	Dans l'UE Cloud Computing, vous aurez une introduction au Cloud sur les modèles : IaaS (Modèle de service, Énergie, Composition), PaaS, SaaS. Ainsi qu'une introduction à Docker, à Swarm et à la virtualisation.
Quels sont les thèmes abordés en Cloud Computing ?	Dans l'UE Cloud Computing, vous aurez une introduction au Cloud sur les modèles : IaaS (Modèle de service, Énergie, Composition), PaaS, SaaS. Ainsi qu'une introduction à Docker, à Swarm et à la virtualisation.
Vous faites quoi en Cloud Computing ?	Dans l'UE Cloud Computing, vous aurez une introduction au Cloud sur les modèles : IaaS (Modèle de service, Énergie, Composition), PaaS, SaaS. Ainsi qu'une introduction à Docker, à Swarm et à la virtualisation.
Quels sont les méthodes enseignées en Cloud Computing ?	Dans l'UE Cloud Computing, vous aurez une introduction au Cloud sur les modèles : IaaS (Modèle de service, Énergie, Composition), PaaS, SaaS. Ainsi qu'une introduction à Docker, à Swarm et à la virtualisation.
Quels sont les algorithmes de Cloud Computing enseignés ?	Dans l'UE Cloud Computing, vous aurez une introduction au Cloud sur les modèles : IaaS (Modèle de service, Énergie, Composition), PaaS, SaaS. Ainsi qu'une introduction à Docker, à Swarm et à la virtualisation.
Vous enseignez quoi en Cloud Computing ?	Dans l'UE Cloud Computing, vous aurez une introduction au Cloud sur les modèles : IaaS (Modèle de service, Énergie, Composition), PaaS, SaaS. Ainsi qu'une introduction à Docker, à Swarm et à la virtualisation.