Quel est l'enseignant du cours de Graphes ?	L'enseignant de Graphes de données est Pr. profAGD
Qui enseigne l'UE d'analyse de graphes ?	L'enseignant de Graphes de données est Pr. profAGD
Qui est le prof de Graphes ?	L'enseignant de Graphes de données est Pr. profAGD
Qui donne le cours de graphes de données ?	L'enseignant de Graphes de données est Pr. profAGD
Quel est l'enseignant du cours de Graphes de données ?	L'enseignant de Graphes de données est Pr. profAGD
Qui enseigne l'UE Graphes de données ?	L'enseignant de Graphes de données est Pr. profAGD
Qui est le prof de Graphes de données ?	L'enseignant de Graphes de données est Pr. profAGD
Quel est l'enseignant de l'UE de graphes ?	L'enseignant de Graphes de données est Pr. profAGD
Qui enseigne le cours de graphes ?	L'enseignant de Graphes de données est Pr. profAGD
Qui fait l'UE de Graphes de données ?	L'enseignant de Graphes de données est Pr. profAGD
Qui fait le cours de graphes ?	L'enseignant de Graphes de données est Pr. profAGD
Quel est le professeur de graphes ?	L'enseignant de Graphes de données est Pr. profAGD
Qui est le responsable du cours de Graphes de données ?	L'enseignant de Graphes de données est Pr. profAGD

Fait-on de l'analyse de graphes ?	Oui, une UE de Graphes de données est au programme
Il y a des cours de Graphes ?	Oui, une UE de Graphes de données est au programme
Y-a-t-il un cours de Graphes ?	Oui, une UE de Graphes de données est au programme
Est ce que le master propose un enseignement en Graphes de données ?	Oui, une UE de Graphes de données est au programme
Est-ce qu'on fait de l'analyse de graphes ?	Oui, une UE de Graphes de données est au programme
Il y a des cours de graphes ?	Oui, une UE de Graphes de données est au programme
Il y a de l'analyse de graphes ?	Oui, une UE de Graphes de données est au programme
Fait on de l'analyse de graphes ?	Oui, une UE de Graphes de données est au programme
Il y a des cours de Graphes de données ?	Oui, une UE de Graphes de données est au programme
Il y a des cours de graphes ?	Oui, une UE de Graphes de données est au programme
Y a-t-il de l'analyse de graphes ?	Oui, une UE de Graphes de données est au programme
Y a-t-il un cours de Graphes de données ?	Oui, une UE de Graphes de données est au programme
On fait de l'analyse de graphes de données ?	Oui, une UE de Graphes de données est au programme
Il y a de l'analyse de graphes de données dans ce master ?	Oui, une UE de Graphes de données est au programme
Est ce qu'il y a des cours de Graphes de données ?	Oui, une UE de Graphes de données est au programme

C'est quoi les Graphes de données ?	Je vous invite à faire une recherche Wikipedia ou à consulter le site de l'enseignant
Qu'est ce que l'analyse de graphes de données ?	Je vous invite à faire une recherche Wikipedia ou à consulter le site de l'enseignant
C'est quoi les graphes ?	Je vous invite à faire une recherche Wikipedia ou à consulter le site de l'enseignant

Que faut il lire en Graphes de données ?	Vous devriez prendre contact avec l'enseignant de l'UE et lui demander
Il y a des livres à lire en graphes ?	Vous devriez prendre contact avec l'enseignant de l'UE et lui demander
Le cours de Graphes de données est-il en ligne ?	Vous devriez prendre contact avec l'enseignant de l'UE et lui demander
Il faut des connaissances préalables en graphes ?	Vous devriez prendre contact avec l'enseignant de l'UE et lui demander

Il y a des TP de Graphes de données ?	Deux travaux pratiques sont proposés en Graphes de données, TP1 : les graphes avec Scala, TP2 : Introduction à Neo4J.
Quels sont les TP de Graphes de données ?	Deux travaux pratiques sont proposés en Graphes de données, TP1 : les graphes avec Scala, TP2 : Introduction à Neo4J.
Il y a des TP de graphes ?	Deux travaux pratiques sont proposés en Graphes de données, TP1 : les graphes avec Scala, TP2 : Introduction à Neo4J.
Il y a des Travaux Pratiques de graphes ?	Deux travaux pratiques sont proposés en Graphes de données, TP1 : les graphes avec Scala, TP2 : Introduction à Neo4J.
Quels sont les Travaux Pratiques de Graphes de données ?	Deux travaux pratiques sont proposés en Graphes de données, TP1 : les graphes avec Scala, TP2 : Introduction à Neo4J.
Il y a des exercices pratiques de graphes ?	Deux travaux pratiques sont proposés en Graphes de données, TP1 : les graphes avec Scala, TP2 : Introduction à Neo4J.
Quels sont les exercices pratiques de Graphes de données ?	Deux travaux pratiques sont proposés en Graphes de données, TP1 : les graphes avec Scala, TP2 : Introduction à Neo4J.

C'est quoi le programme de Graphes de données ?	Dans l'UE Graphes de données, vous verrez l'état actuel de la recherche en graphes de données, les applications possibles et la maîtrise des outils récents.
On fait quoi en Graphes de données ?	Dans l'UE Graphes de données, vous verrez l'état actuel de la recherche en graphes de données, les applications possibles et la maîtrise des outils récents.
Quel est le contenu de l'UE Graphes de données ?	Dans l'UE Graphes de données, vous verrez l'état actuel de la recherche en graphes de données, les applications possibles et la maîtrise des outils récents.
Quel est le contenu du cours de Graphes de données ?	Dans l'UE Graphes de données, vous verrez l'état actuel de la recherche en graphes de données, les applications possibles et la maîtrise des outils récents.
Quels sont les thèmes abordés en Graphes de données ?	Dans l'UE Graphes de données, vous verrez l'état actuel de la recherche en graphes de données, les applications possibles et la maîtrise des outils récents.
Vous faites quoi en Graphes de données?	Dans l'UE Graphes de données, vous verrez l'état actuel de la recherche en graphes de données, les applications possibles et la maîtrise des outils récents.
Quels sont les méthodes enseignées en Graphes de données ?	Dans l'UE Graphes de données, vous verrez l'état actuel de la recherche en graphes de données, les applications possibles et la maîtrise des outils récents.
Quels sont les algorithmes de Graphes de données enseignés ?	Dans l'UE Graphes de données, vous verrez l'état actuel de la recherche en graphes de données, les applications possibles et la maîtrise des outils récents.
Vous enseignez quoi en Graphes de données ?	Dans l'UE Graphes de données, vous verrez l'état actuel de la recherche en graphes de données, les applications possibles et la maîtrise des outils récents.