Quel est l'enseignant du cours de Modèles de régression ?	L'enseignant de Modèles de régression est Pr. profMR
Qui enseigne l'UE de Modèles de régression ?	L'enseignant de Modèles de régression est Pr. profMR
Qui est le prof de Modèles de régression ?	L'enseignant de Modèles de régression est Pr. profMR
Qui donne le cours de Modèles de régression ?	L'enseignant de Modèles de régression est Pr. profMR
Qui enseigne l'UE Modèles de régression ?	L'enseignant de Modèles de régression est Pr. profMR
Quel est l'enseignant de l'UE de Modèles de régression ?	L'enseignant de Modèles de régression est Pr. profMR
Qui enseigne le cours de Modèles de régression ?	L'enseignant de Modèles de régression est Pr. profMR
Qui fait l'UE de Modèles de régression ?	L'enseignant de Modèles de régression est Pr. profMR
Qui fait le cours de Modèles de régression ?	L'enseignant de Modèles de régression est Pr. profMR
Quel est le professeur de Modèles de régression ?	L'enseignant de Modèles de régression est Pr. profMR
Qui est le responsable du cours de Modèles de régression ?	L'enseignant de Modèles de régression est Pr. profMR

Fait-on de la Modèles de régression ?	Oui, une UE de Modèles de régression est au programme
Y a-t-il des cours de Modèles de régression ?	Oui, une UE de Modèles de régression est au programme
Est ce que le master propose un enseignement en Modèles de régression ?	Oui, une UE de Modèles de régression est au programme
Est-ce qu'on fait des Modèles de régression ?	Oui, une UE de Modèles de régression est au programme
Il y a des cours de Modèles de régression ?	Oui, une UE de Modèles de régression est au programme
Il y a des Modèles de régression ?	Oui, une UE de Modèles de régression est au programme
Fait on des Modèles de régression ?	Oui, une UE de Modèles de régression est au programme
Y a-t-il des Modèles de régression ?	Oui, une UE de Modèles de régression est au programme
Y a-t-il un cours de Modèles de régression ?	Oui, une UE de Modèles de régression est au programme
On fait des Modèles de régression ?	Oui, une UE de Modèles de régression est au programme
On fait des Modèles de régression ?	Oui, une UE de Modèles de régression est au programme
Il y a des Modèles de régression dans ce master ?	Oui, une UE de Modèles de régression est au programme
Est ce qu'il y a des cours de Modèles de régression ?	Oui, une UE de Modèles de régression est au programme

C'est quoi les modèles de régression ?	Je vous invite à faire une recherche Wikipedia ou à consulter le site de l'enseignant
Qu'est ce que Modèles de régression ?	Je vous invite à faire une recherche Wikipedia ou à consulter le site de l'enseignant

Que faut il lire en Modèles de régression ?	Vous devriez prendre contact avec l'enseignant de l'UE et lui demander
Il y a des livres à lire en Modèles de régression ?	Vous devriez prendre contact avec l'enseignant de l'UE et lui demander
Le cours de Modèles de régression est-il en ligne ?	Vous devriez prendre contact avec l'enseignant de l'UE et lui demander
Il faut des connaissances préalables en Modèles de régression ?	Vous devriez prendre contact avec l'enseignant de l'UE et lui demander

Il y a des TP de Modèles de régression ?	Trois travaux pratiques sont proposés en Modèles de régression, TP1 : régression linéaire, TP2 : analyse de variance/covariance, TP3 : régression LASSO , régression PLS et régression logistique.
Quels sont les TP de Modèles de régression ?	Trois travaux pratiques sont proposés en Modèles de régression, TP1 : régression linéaire, TP2 : analyse de variance/covariance, TP3 : régression LASSO , régression PLS et régression logistique.
Il y a des TP de Modèles de régression ?	Trois travaux pratiques sont proposés en Modèles de régression, TP1 : régression linéaire, TP2 : analyse de variance/covariance, TP3 : régression LASSO , régression PLS et régression logistique.
Il y a des Travaux Pratiques de Modèles de régression ?	Trois travaux pratiques sont proposés en Modèles de régression, TP1 : régression linéaire, TP2 : analyse de variance/covariance, TP3 : régression LASSO , régression PLS et régression logistique.
Quels sont les Travaux Pratiques de Modèles de régression ?	Trois travaux pratiques sont proposés en Modèles de régression, TP1 : régression linéaire, TP2 : analyse de variance/covariance, TP3 : régression LASSO , régression PLS et régression logistique.
Il y a des exercices pratiques de Modèles de régression ?	Trois travaux pratiques sont proposés en Modèles de régression, TP1 : régression linéaire, TP2 : analyse de variance/covariance, TP3 : régression LASSO , régression PLS et régression logistique.
Quels sont les exercices pratiques de Modèles de régression ?	Trois travaux pratiques sont proposés en Modèles de régression, TP1 : régression linéaire, TP2 : analyse de variance/covariance, TP3 : régression LASSO , régression PLS et régression logistique.

C'est quoi le programme de Modèles de régression ?	Dans l'UE Modèles de régression, vous verrez la régression linéaire, la régression logistique, la régression PLS, la régression LASSO, l'analyse de variance et de covariance.
On fait quoi en Modèles de régression ?	Dans l'UE Modèles de régression, vous verrez la régression linéaire, la régression logistique, la régression PLS, la régression LASSO, l'analyse de variance et de covariance.
Quel est le contenu de l'UE Modèles de régression ?	Dans l'UE Modèles de régression, vous verrez la régression linéaire, la régression logistique, la régression PLS, la régression LASSO, l'analyse de variance et de covariance.
Quel est le contenu du cours de Modèles de régression ?	Dans l'UE Modèles de régression, vous verrez la régression linéaire, la régression logistique, la régression PLS, la régression LASSO, l'analyse de variance et de covariance.
Quels sont les thèmes abordés en Modèles de régression ?	Dans l'UE Modèles de régression, vous verrez la régression linéaire, la régression logistique, la régression PLS, la régression LASSO, l'analyse de variance et de covariance.
Vous faites quoi en Modèles de régression?	Dans l'UE Modèles de régression, vous verrez la régression linéaire, la régression logistique, la régression PLS, la régression LASSO, l'analyse de variance et de covariance.
Quels sont les méthodes enseignées en Modèles de régression ?	Dans l'UE Modèles de régression, vous verrez la régression linéaire, la régression logistique, la régression PLS, la régression LASSO, l'analyse de variance et de covariance.
Quels sont les algorithmes de Modèles de régression enseignés ?	Dans l'UE Modèles de régression, vous verrez la régression linéaire, la régression logistique, la régression PLS, la régression LASSO, l'analyse de variance et de covariance.
Vous enseignez quoi en Modèles de régression ?	Dans l'UE Modèles de régression, vous verrez la régression linéaire, la régression logistique, la régression PLS, la régression LASSO, l'analyse de variance et de covariance.