Quel est l'enseignant du cours de Modèles graphiques probabilistes ?	L'enseignant de Modèles graphiques probabilistes est Pr. profPGM
Qui enseigne l'UE Modèles graphiques probabilistes ?	L'enseignant de Modèles graphiques probabilistes est Pr. profPGM
Qui est le prof de Modèles graphiques probabilistes ?	L'enseignant de Modèles graphiques probabilistes est Pr. profPGM
Qui donne le cours de Modèles graphiques probabilistes ?	L'enseignant de Modèles graphiques probabilistes est Pr. profPGM
Quel est l'enseignant du cours de PGM ?	L'enseignant de Modèles graphiques probabilistes est Pr. profPGM
Qui enseigne l'UE PGM ?	L'enseignant de Modèles graphiques probabilistes est Pr. profPGM
Qui est le prof de PGM ?	L'enseignant de Modèles graphiques probabilistes est Pr. profPGM
Qui donne le cours de PGM ?	L'enseignant de Modèles graphiques probabilistes est Pr. profPGM
Quel est l'enseignant de l'UE de PGM ?	L'enseignant de Modèles graphiques probabilistes est Pr. profPGM
Qui enseigne le cours de PGM ?	L'enseignant de Modèles graphiques probabilistes est Pr. profPGM
Qui fait l'UE de Modèles graphiques probabilistes ?	L'enseignant de Modèles graphiques probabilistes est Pr. profPGM
Qui fait le cours de PGM ?	L'enseignant de Modèles graphiques probabilistes est Pr. profPGM
Quel est le professeur de PGM ?	L'enseignant de Modèles graphiques probabilistes est Pr. profPGM
Qui est le responsable du cours de Modèles graphiques probabilistes ?	L'enseignant de Modèles graphiques probabilistes est Pr. profPGM

Y a-t-il des cours de PGM ?	Oui, une UE de Modèles graphiques probabilistes est au programme
Est ce que le master propose un enseignement en Modèles graphiques probabilistes ?	Oui, une UE de Modèles graphiques probabilistes est au programme
Est-ce qu'on fait des Modèles graphiques probabilistes ?	Oui, une UE de Modèles graphiques probabilistes est au programme
Il y a des Modèles graphiques probabilistes ?	Oui, une UE de Modèles graphiques probabilistes est au programme
Fait on des Modèles graphiques probabilistes ?	Oui, une UE de Modèles graphiques probabilistes est au programme
Il y a des cours de Modèles graphiques probabilistes ?	Oui, une UE de Modèles graphiques probabilistes est au programme
Il y a des cours de PGM ?	Oui, une UE de Modèles graphiques probabilistes est au programme
Y a-t-il des Modèles graphiques probabilistes ?	Oui, une UE de Modèles graphiques probabilistes est au programme
Y a-t-il un cours de Modèles graphiques probabilistes ?	Oui, une UE de Modèles graphiques probabilistes est au programme
On fait des Modèles graphiques probabilistes ?	Oui, une UE de Modèles graphiques probabilistes est au programme
Il y a des Modèles graphiques probabilistes dans ce master ?	Oui, une UE de Modèles graphiques probabilistes est au programme
Est ce qu'il y a des cours de Modèles graphiques probabilistes ?	Oui, une UE de Modèles graphiques probabilistes est au programme

C'est quoi les Modèles graphiques probabilistes ?	Je vous invite à faire une recherche Wikipedia ou à consulter le site de l'enseignant
Qu'est ce que les Modèles graphiques probabilistes ?	Je vous invite à faire une recherche Wikipedia ou à consulter le site de l'enseignant
C'est quoi PGM ?	Je vous invite à faire une recherche Wikipedia ou à consulter le site de l'enseignant

Que faut il lire en Modèles graphiques probabilistes ?	Vous devriez prendre contact avec l'enseignant de l'UE et lui demander
Il y a des livres à lire en PGM ?	Vous devriez prendre contact avec l'enseignant de l'UE et lui demander
Le cours de Modèles graphiques probabilistes est-il en ligne ?	Vous devriez prendre contact avec l'enseignant de l'UE et lui demander
Il faut des connaissances préalables en PGM ?	Vous devriez prendre contact avec l'enseignant de l'UE et lui demander

Quels sont les TP de PGM ?	Il y a plusieurs TP, sur les réseaux bayésien, les modèles de Markov caché ainsi que les réseaux de neurones profond.
Il y a des TP de Modèles graphiques probabilistes ?	Il y a plusieurs TP, sur les réseaux bayésien, les modèles de Markov caché ainsi que les réseaux de neurones profond.
Quels sont les TP de Modèles graphiques probabilistes ?	Il y a plusieurs TP, sur les réseaux bayésien, les modèles de Markov caché ainsi que les réseaux de neurones profond.
Il y a des TP de PGM ?	Il y a plusieurs TP, sur les réseaux bayésien, les modèles de Markov caché ainsi que les réseaux de neurones profond.
Il y a des Travaux Pratiques de PGM ?	Il y a plusieurs TP, sur les réseaux bayésien, les modèles de Markov caché ainsi que les réseaux de neurones profond.
Quels sont les Travaux Pratiques de Modèles graphiques probabilistes ?	Il y a plusieurs TP, sur les réseaux bayésien, les modèles de Markov caché ainsi que les réseaux de neurones profond.
Il y a des exercices pratiques de PGM ?	Il y a plusieurs TP, sur les réseaux bayésien, les modèles de Markov caché ainsi que les réseaux de neurones profond.
Quels sont les exercices pratiques de Modèles graphiques probabilistes ?	Il y a plusieurs TP, sur les réseaux bayésien, les modèles de Markov caché ainsi que les réseaux de neurones profond.

C'est quoi le programme de PGM ?	Vous verrez les réseaux bayésien, les modèles de Markov caché ainsi que les réseaux de neurones profond.
On fait quoi en PGM ?	Vous verrez les réseaux bayésien, les modèles de Markov caché ainsi que les réseaux de neurones profond.
C'est quoi le programme de Modèles graphiques probabilistes ?	Vous verrez les réseaux bayésien, les modèles de Markov caché ainsi que les réseaux de neurones profond.
On fait quoi en Modèles graphiques probabilistes ?	Vous verrez les réseaux bayésien, les modèles de Markov caché ainsi que les réseaux de neurones profond.
Quel est le contenu de l'UE Modèles graphiques probabilistes ?	Vous verrez les réseaux bayésien, les modèles de Markov caché ainsi que les réseaux de neurones profond.
Quel est le contenu du cours de Modèles graphiques probabilistes ?	Vous verrez les réseaux bayésien, les modèles de Markov caché ainsi que les réseaux de neurones profond.
Quels sont les thèmes abordés en Modèles graphiques probabilistes ?	Vous verrez les réseaux bayésien, les modèles de Markov caché ainsi que les réseaux de neurones profond.
Vous faites quoi en Modèles graphiques probabilistes?	Vous verrez les réseaux bayésien, les modèles de Markov caché ainsi que les réseaux de neurones profond.
Quels sont les méthodes enseignées en Modèles graphiques probabilistes ?	Vous verrez les réseaux bayésien, les modèles de Markov caché ainsi que les réseaux de neurones profond.
Quels sont les algorithmes de Modèles graphiques probabilistes enseignés ?	Vous verrez les réseaux bayésien, les modèles de Markov caché ainsi que les réseaux de neurones profond.
Vous enseignez quoi en Modèles graphiques probabilistes ?	Vous verrez les réseaux bayésien, les modèles de Markov caché ainsi que les réseaux de neurones profond.